County,Precinct,Michael Mason,Michael Mason Percent,Peter J. Roskam,Peter J. Roskam Percent,Total
Cook,7000001,138,28.87,340,71.13,478
Cook,7000002,159,36.98,271,63.02,430
Cook,7000003,109,18.76,472,81.24,581
Cook,7000005,90,15.52,490,84.48,580
Cook,7000006,192,32.16,405,67.84,597
Cook,7000007,39,21.67,141,78.33,180
Cook,7000008,117,17.97,534,82.03,651
Cook,7000009,122,30.89,273,69.11,395
Cook,7000012,130,35.14,240,64.86,370
Cook,7600009,157,34.97,292,65.03,449
Cook,7600026,165,37.25,278,62.75,443
Cook,7600031,99,27.50,261,72.50,360
Cook,7600042,152,40.21,226,59.79,378
Cook,7600044,97,32.01,206,67.99,303
Cook,7900012,67,19.76,272,80.24,339
Cook,7900027,35,14.64,204,85.36,239
Cook,8700001,131,40.18,195,59.82,326
Cook,8700002,185,31.41,404,68.59,589
Cook,8700003,83,19.12,351,80.88,434
Cook,8700006,178,37.47,297,62.53,475
Cook,8700007,194,39.11,302,60.89,496
Cook,8700008,192,39.02,300,60.98,492
Cook,8700009,128,25.96,365,74.04,493
Cook,8700010,124,20.23,489,79.77,613
Cook,8700011,116,35.26,213,64.74,329
Cook,8700012,105,23.54,341,76.46,446
Cook,8700014,169,41.63,237,58.37,406
Cook,8700015,160,39.02,250,60.98,410
Cook,8700017,191,42.07,263,57.93,454
Cook,8700018,131,40.31,194,59.69,325
Cook,8700019,153,29.42,367,70.58,520
Cook,8700020,169,59.09,117,40.91,286
Cook,8700023,80,20.89,303,79.11,383
Cook,8700025,143,36.11,253,63.89,396
Cook,8700028,124,37.69,205,62.31,329
Cook,8700029,186,36.26,327,63.74,513
Cook,8700030,161,44.72,199,55.28,360
Cook,8700031,112,29.55,267,70.45,379
Cook,8700032,151,31.07,335,68.93,486
Cook,8700033,107,47.98,116,52.02,223
Cook,8700034,202,33.11,408,66.89,610
Cook,8700035,163,37.13,276,62.87,439
Cook,8700036,126,34.24,242,65.76,368
Cook,8700037,195,39.71,296,60.29,491
Cook,8700038,118,24.95,355,75.05,473
Cook,8700040,232,33.97,451,66.03,683
Cook,8700041,180,29.85,423,70.15,603
Cook,8700042,222,39.36,342,60.64,564
Cook,8700043,162,39.61,247,60.39,409
Cook,8700044,126,18.56,553,81.44,679
Cook,8700045,108,25.17,321,74.83,429
Cook,8700046,211,38.72,334,61.28,545
Cook,8700048,115,26.50,319,73.50,434
Cook,8700049,89,25.00,267,75.00,356
Cook,8700050,220,32.07,466,67.93,686
Cook,8700052,138,27.01,373,72.99,511
Cook,8700054,215,34.18,414,65.82,629
Cook,8700055,95,27.70,248,72.30,343
Cook,8700056,142,32.05,301,67.95,443
Cook,8700057,251,41.69,351,58.31,602
Cook,8700063,172,39.91,259,60.09,431
Cook,8700064,159,41.41,225,58.59,384
Cook,8700065,120,32.52,249,67.48,369
Cook,8700067,80,16.29,411,83.71,491
Cook,8700068,125,30.56,284,69.44,409
Cook,8700069,143,38.44,229,61.56,372
DuPage,Bloomingdale 009,181,33.58,358,66.42,539
DuPage,Bloomingdale 018,161,37.44,269,62.56,430
DuPage,Bloomingdale 043,86,32.45,179,67.55,265
DuPage,Bloomingdale 045,39,12.58,271,87.42,310
DuPage,Bloomingdale 058,224,36.96,382,63.04,606
DuPage,Bloomingdale 068,186,36.33,326,63.67,512
DuPage,Downers Grove 002,148,37.37,248,62.63,396
DuPage,Downers Grove 003,121,38.29,195,61.71,316
DuPage,Downers Grove 006,94,27.09,253,72.91,347
DuPage,Downers Grove 007,111,22.89,374,77.11,485
DuPage,Downers Grove 008,213,38.59,339,61.41,552
DuPage,Downers Grove 009,148,43.27,194,56.73,342
DuPage,Downers Grove 010,185,44.79,228,55.21,413
DuPage,Downers Grove 011,138,31.08,306,68.92,444
DuPage,Downers Grove 012,150,42.02,207,57.98,357
DuPage,Downers Grove 014,156,36.71,269,63.29,425
DuPage,Downers Grove 015,119,39.27,184,60.73,303
DuPage,Downers Grove 016,64,20.38,250,79.62,314
DuPage,Downers Grove 017,170,37.95,278,62.05,448
DuPage,Downers Grove 018,170,40.87,246,59.13,416
DuPage,Downers Grove 019,102,43.22,134,56.78,236
DuPage,Downers Grove 020,198,39.60,302,60.40,500
DuPage,Downers Grove 021,149,35.65,269,64.35,418
DuPage,Downers Grove 026,173,39.68,263,60.32,436
DuPage,Downers Grove 027,73,29.44,175,70.56,248
DuPage,Downers Grove 028,74,23.79,237,76.21,311
DuPage,Downers Grove 029,133,28.66,331,71.34,464
DuPage,Downers Grove 030,136,43.59,176,56.41,312
DuPage,Downers Grove 031,158,45.53,189,54.47,347
DuPage,Downers Grove 032,108,30.25,249,69.75,357
DuPage,Downers Grove 033,148,46.98,167,53.02,315
DuPage,Downers Grove 034,214,44.40,268,55.60,482
DuPage,Downers Grove 036,169,33.53,335,66.47,504
DuPage,Downers Grove 037,143,27.45,378,72.55,521
DuPage,Downers Grove 038,96,23.02,321,76.98,417
DuPage,Downers Grove 039,107,33.65,211,66.35,318
DuPage,Downers Grove 044,89,26.57,246,73.43,335
DuPage,Downers Grove 045,127,32.15,268,67.85,395
DuPage,Downers Grove 047,78,36.28,137,63.72,215
DuPage,Downers Grove 048,93,33.82,182,66.18,275
DuPage,Downers Grove 049,170,41.46,240,58.54,410
DuPage,Downers Grove 050,162,39.13,252,60.87,414
DuPage,Downers Grove 051,141,37.01,240,62.99,381
DuPage,Downers Grove 052,149,35.56,270,64.44,419
DuPage,Downers Grove 053,185,38.14,300,61.86,485
DuPage,Downers Grove 054,179,33.15,361,66.85,540
DuPage,Downers Grove 055,66,22.07,233,77.93,299
DuPage,Downers Grove 056,88,37.29,148,62.71,236
DuPage,Downers Grove 057,135,37.92,221,62.08,356
DuPage,Downers Grove 059,116,29.74,274,70.26,390
DuPage,Downers Grove 061,134,31.53,291,68.47,425
DuPage,Downers Grove 063,123,45.56,147,54.44,270
DuPage,Downers Grove 064,184,32.34,385,67.66,569
DuPage,Downers Grove 065,131,32.75,269,67.25,400
DuPage,Downers Grove 066,107,33.13,216,66.87,323
DuPage,Downers Grove 067,163,34.75,306,65.25,469
DuPage,Downers Grove 069,105,42.17,144,57.83,249
DuPage,Downers Grove 070,162,26.87,441,73.13,603
DuPage,Downers Grove 071,189,58.15,136,41.85,325
DuPage,Downers Grove 073,115,35.94,205,64.06,320
DuPage,Downers Grove 074,165,37.16,279,62.84,444
DuPage,Downers Grove 075,135,35.25,248,64.75,383
DuPage,Downers Grove 076,168,52.66,151,47.34,319
DuPage,Downers Grove 078,92,29.39,221,70.61,313
DuPage,Downers Grove 079,176,29.73,416,70.27,592
DuPage,Downers Grove 082,114,30.08,265,69.92,379
DuPage,Downers Grove 083,96,19.71,391,80.29,487
DuPage,Downers Grove 084,101,26.23,284,73.77,385
DuPage,Downers Grove 085,79,23.44,258,76.56,337
DuPage,Downers Grove 087,198,32.35,414,67.65,612
DuPage,Downers Grove 092,226,35.42,412,64.58,638
DuPage,Downers Grove 094,181,41.51,255,58.49,436
DuPage,Downers Grove 096,147,46.96,166,53.04,313
DuPage,Downers Grove 097,127,33.16,256,66.84,383
DuPage,Downers Grove 098,97,27.09,261,72.91,358
DuPage,Downers Grove 102,149,28.60,372,71.40,521
DuPage,Downers Grove 103,100,36.63,173,63.37,273
DuPage,Downers Grove 105,187,48.45,199,51.55,386
DuPage,Downers Grove 106,108,31.67,233,68.33,341
DuPage,Downers Grove 107,82,29.39,197,70.61,279
DuPage,Downers Grove 109,110,24.72,335,75.28,445
DuPage,Downers Grove 112,124,36.26,218,63.74,342
DuPage,Downers Grove 113,212,44.26,267,55.74,479
DuPage,Downers Grove 115,141,37.70,233,62.30,374
DuPage,Downers Grove 118,176,54.49,147,45.51,323
DuPage,Downers Grove 119,72,24.16,226,75.84,298
DuPage,Downers Grove 120,156,36.28,274,63.72,430
DuPage,Downers Grove 121,108,31.86,231,68.14,339
DuPage,Downers Grove 127,146,43.32,191,56.68,337
DuPage,Downers Grove 129,167,43.83,214,56.17,381
DuPage,Downers Grove 130,130,49.62,132,50.38,262
DuPage,Downers Grove 131,89,45.41,107,54.59,196
DuPage,Downers Grove 132,52,20.31,204,79.69,256
DuPage,Lisle 001,68,42.77,91,57.23,159
DuPage,Lisle 003,205,31.01,456,68.99,661
DuPage,Lisle 004,164,42.71,220,57.29,384
DuPage,Lisle 006,88,33.33,176,66.67,264
DuPage,Lisle 007,61,31.28,134,68.72,195
DuPage,Lisle 008,166,47.84,181,52.16,347
DuPage,Lisle 009,118,37.11,200,62.89,318
DuPage,Lisle 011,158,34.88,295,65.12,453
DuPage,Lisle 014,122,22.26,426,77.74,548
DuPage,Lisle 016,185,36.27,325,63.73,510
DuPage,Lisle 022,130,30.52,296,69.48,426
DuPage,Lisle 025,107,32.04,227,67.96,334
DuPage,Lisle 031,136,31.63,294,68.37,430
DuPage,Lisle 032,104,36.88,178,63.12,282
DuPage,Lisle 037,132,32.51,274,67.49,406
DuPage,Lisle 038,137,49.46,140,50.54,277
DuPage,Lisle 040,125,38.34,201,61.66,326
DuPage,Lisle 043,158,23.55,513,76.45,671
DuPage,Lisle 044,116,37.42,194,62.58,310
DuPage,Lisle 052,179,33.46,356,66.54,535
DuPage,Lisle 055,121,39.93,182,60.07,303
DuPage,Lisle 056,213,37.04,362,62.96,575
DuPage,Lisle 059,150,33.63,296,66.37,446
DuPage,Lisle 061,198,43.42,258,56.58,456
DuPage,Lisle 068,117,26.17,330,73.83,447
DuPage,Lisle 077,240,46.78,273,53.22,513
DuPage,Lisle 078,315,38.00,514,62.00,829
DuPage,Lisle 080,85,32.95,173,67.05,258
DuPage,Lisle 081,95,25.13,283,74.87,378
DuPage,Lisle 083,137,35.31,251,64.69,388
DuPage,Lisle 088,121,39.03,189,60.97,310
DuPage,Lisle 089,147,41.41,208,58.59,355
DuPage,Lisle 091,154,35.48,280,64.52,434
DuPage,Lisle 092,69,45.10,84,54.90,153
DuPage,Lisle 095,92,25.27,272,74.73,364
DuPage,Milton 001,87,33.33,174,66.67,261
DuPage,Milton 002,163,38.17,264,61.83,427
DuPage,Milton 003,148,29.60,352,70.40,500
DuPage,Milton 004,82,23.91,261,76.09,343
DuPage,Milton 005,124,33.24,249,66.76,373
DuPage,Milton 006,133,38.33,214,61.67,347
DuPage,Milton 007,91,34.34,174,65.66,265
DuPage,Milton 008,130,26.21,366,73.79,496
DuPage,Milton 009,83,31.68,179,68.32,262
DuPage,Milton 010,132,34.38,252,65.63,384
DuPage,Milton 011,125,36.13,221,63.87,346
DuPage,Milton 012,102,35.92,182,64.08,284
DuPage,Milton 013,141,33.41,281,66.59,422
DuPage,Milton 014,109,28.17,278,71.83,387
DuPage,Milton 015,150,35.13,277,64.87,427
DuPage,Milton 016,133,32.76,273,67.24,406
DuPage,Milton 017,151,26.49,419,73.51,570
DuPage,Milton 018,124,25.31,366,74.69,490
DuPage,Milton 019,141,27.22,377,72.78,518
DuPage,Milton 020,102,24.94,307,75.06,409
DuPage,Milton 021,137,42.81,183,57.19,320
DuPage,Milton 022,76,30.77,171,69.23,247
DuPage,Milton 023,118,29.43,283,70.57,401
DuPage,Milton 024,94,39.83,142,60.17,236
DuPage,Milton 025,105,19.63,430,80.37,535
DuPage,Milton 026,235,43.12,310,56.88,545
DuPage,Milton 027,137,37.53,228,62.47,365
DuPage,Milton 028,84,24.21,263,75.79,347
DuPage,Milton 029,114,37.87,187,62.13,301
DuPage,Milton 030,119,29.38,286,70.62,405
DuPage,Milton 031,143,33.97,278,66.03,421
DuPage,Milton 032,158,29.59,376,70.41,534
DuPage,Milton 033,112,37.84,184,62.16,296
DuPage,Milton 034,133,38.66,211,61.34,344
DuPage,Milton 035,110,36.42,192,63.58,302
DuPage,Milton 036,144,40.45,212,59.55,356
DuPage,Milton 037,86,21.94,306,78.06,392
DuPage,Milton 038,177,39.42,272,60.58,449
DuPage,Milton 039,136,25.90,389,74.10,525
DuPage,Milton 040,126,33.69,248,66.31,374
DuPage,Milton 041,118,39.86,178,60.14,296
DuPage,Milton 042,124,43.51,161,56.49,285
DuPage,Milton 043,122,28.44,307,71.56,429
DuPage,Milton 044,150,40.21,223,59.79,373
DuPage,Milton 045,143,36.29,251,63.71,394
DuPage,Milton 046,125,32.30,262,67.70,387
DuPage,Milton 047,176,44.11,223,55.89,399
DuPage,Milton 048,115,34.43,219,65.57,334
DuPage,Milton 049,96,29.81,226,70.19,322
DuPage,Milton 050,153,39.84,231,60.16,384
DuPage,Milton 051,89,23.42,291,76.58,380
DuPage,Milton 052,129,36.34,226,63.66,355
DuPage,Milton 054,124,24.46,383,75.54,507
DuPage,Milton 055,144,30.38,330,69.62,474
DuPage,Milton 056,110,37.93,180,62.07,290
DuPage,Milton 057,152,27.24,406,72.76,558
DuPage,Milton 058,187,35.02,347,64.98,534
DuPage,Milton 059,80,27.97,206,72.03,286
DuPage,Milton 060,171,33.60,338,66.40,509
DuPage,Milton 061,119,21.40,437,78.60,556
DuPage,Milton 062,167,38.39,268,61.61,435
DuPage,Milton 063,140,33.02,284,66.98,424
DuPage,Milton 064,164,42.82,219,57.18,383
DuPage,Milton 065,95,26.17,268,73.83,363
DuPage,Milton 066,164,37.88,269,62.12,433
DuPage,Milton 067,139,35.64,251,64.36,390
DuPage,Milton 068,164,40.69,239,59.31,403
DuPage,Milton 069,131,41.32,186,58.68,317
DuPage,Milton 071,104,27.08,280,72.92,384
DuPage,Milton 073,201,33.44,400,66.56,601
DuPage,Milton 074,105,26.79,287,73.21,392
DuPage,Milton 075,93,25.91,266,74.09,359
DuPage,Milton 076,144,38.10,234,61.90,378
DuPage,Milton 077,78,22.67,266,77.33,344
DuPage,Milton 078,122,45.86,144,54.14,266
DuPage,Milton 079,125,28.80,309,71.20,434
DuPage,Milton 080,115,41.97,159,58.03,274
DuPage,Milton 081,146,35.70,263,64.30,409
DuPage,Milton 082,108,28.72,268,71.28,376
DuPage,Milton 083,140,35.35,256,64.65,396
DuPage,Milton 084,132,30.21,305,69.79,437
DuPage,Milton 085,101,40.08,151,59.92,252
DuPage,Milton 086,94,39.66,143,60.34,237
DuPage,Milton 087,109,20.92,412,79.08,521
DuPage,Milton 088,150,37.41,251,62.59,401
DuPage,Milton 089,159,37.77,262,62.23,421
DuPage,Milton 090,166,28.57,415,71.43,581
DuPage,Milton 091,82,32.28,172,67.72,254
DuPage,Milton 092,85,28.91,209,71.09,294
DuPage,Milton 093,135,37.19,228,62.81,363
DuPage,Milton 094,99,35.36,181,64.64,280
DuPage,Milton 095,115,21.90,410,78.10,525
DuPage,Milton 096,120,35.50,218,64.50,338
DuPage,Milton 097,172,38.57,274,61.43,446
DuPage,Milton 098,78,25.41,229,74.59,307
DuPage,Milton 099,141,33.18,284,66.82,425
DuPage,Milton 100,168,30.16,389,69.84,557
DuPage,Milton 102,141,20.95,532,79.05,673
DuPage,Milton 104,109,47.81,119,52.19,228
DuPage,Milton 105,89,36.33,156,63.67,245
DuPage,Milton 106,156,26.17,440,73.83,596
DuPage,Milton 107,99,25.06,296,74.94,395
DuPage,Milton 108,158,36.41,276,63.59,434
DuPage,Milton 109,72,19.05,306,80.95,378
DuPage,Naperville 005,156,40.21,232,59.79,388
DuPage,Naperville 007,131,38.08,213,61.92,344
DuPage,Naperville 010,163,30.07,379,69.93,542
DuPage,Naperville 015,146,45.63,174,54.38,320
DuPage,Naperville 016,141,24.78,428,75.22,569
DuPage,Naperville 019,159,37.41,266,62.59,425
DuPage,Naperville 022,147,31.61,318,68.39,465
DuPage,Naperville 026,167,33.67,329,66.33,496
DuPage,Naperville 031,139,41.12,199,58.88,338
DuPage,Naperville 061,108,24.66,330,75.34,438
DuPage,Wayne 001,90,20.32,353,79.68,443
DuPage,Wayne 002,52,22.13,183,77.87,235
DuPage,Wayne 003,182,30.90,407,69.10,589
DuPage,Wayne 004,157,33.26,315,66.74,472
DuPage,Wayne 005,163,29.80,384,70.20,547
DuPage,Wayne 006,189,32.36,395,67.64,584
DuPage,Wayne 007,156,35.94,278,64.06,434
DuPage,Wayne 008,131,25.05,392,74.95,523
DuPage,Wayne 009,149,27.44,394,72.56,543
DuPage,Wayne 010,86,18.07,390,81.93,476
DuPage,Wayne 011,136,27.70,355,72.30,491
DuPage,Wayne 012,147,37.89,241,62.11,388
DuPage,Wayne 013,187,31.48,407,68.52,594
DuPage,Wayne 015,178,46.23,207,53.77,385
DuPage,Wayne 017,222,31.14,491,68.86,713
DuPage,Wayne 019,134,42.41,182,57.59,316
DuPage,Wayne 020,132,33.08,267,66.92,399
DuPage,Wayne 021,206,38.08,335,61.92,541
DuPage,Wayne 022,99,27.42,262,72.58,361
DuPage,Wayne 023,139,35.82,249,64.18,388
DuPage,Wayne 025,162,38.57,258,61.43,420
DuPage,Wayne 026,84,30.43,192,69.57,276
DuPage,Wayne 028,148,38.44,237,61.56,385
DuPage,Wayne 030,172,33.99,334,66.01,506
DuPage,Wayne 032,81,23.34,266,76.66,347
DuPage,Wayne 033,102,32.59,211,67.41,313
DuPage,Wayne 035,134,28.51,336,71.49,470
DuPage,Wayne 036,122,28.98,299,71.02,421
DuPage,Wayne 037,151,25.77,435,74.23,586
DuPage,Wayne 039,137,37.95,224,62.05,361
DuPage,Wayne 040,167,32.94,340,67.06,507
DuPage,Wayne 042,185,39.61,282,60.39,467
DuPage,Winfield 001,132,42.86,176,57.14,308
DuPage,Winfield 002,142,31.21,313,68.79,455
DuPage,Winfield 004,150,32.40,313,67.60,463
DuPage,Winfield 005,107,35.20,197,64.80,304
DuPage,Winfield 006,86,25.90,246,74.10,332
DuPage,Winfield 007,114,25.62,331,74.38,445
DuPage,Winfield 008,61,27.11,164,72.89,225
DuPage,Winfield 009,166,61.48,104,38.52,270
DuPage,Winfield 012,154,35.65,278,64.35,432
DuPage,Winfield 013,93,49.21,96,50.79,189
DuPage,Winfield 014,153,34.30,293,65.70,446
DuPage,Winfield 015,104,34.10,201,65.90,305
DuPage,Winfield 017,108,36.73,186,63.27,294
DuPage,Winfield 018,95,27.86,246,72.14,341
DuPage,Winfield 019,88,21.95,313,78.05,401
DuPage,Winfield 020,111,26.49,308,73.51,419
DuPage,Winfield 021,185,35.85,331,64.15,516
DuPage,Winfield 022,122,28.50,306,71.50,428
DuPage,Winfield 023,124,34.83,232,65.17,356
DuPage,Winfield 030,144,27.38,382,72.62,526
DuPage,Winfield 037,103,39.77,156,60.23,259
DuPage,York 003,64,23.70,206,76.30,270
DuPage,York 009,137,44.19,173,55.81,310
DuPage,York 018,213,41.60,299,58.40,512
DuPage,York 021,87,44.39,109,55.61,196
DuPage,York 026,200,40.98,288,59.02,488
DuPage,York 030,55,18.27,246,81.73,301
DuPage,York 042,115,40.07,172,59.93,287
DuPage,York 043,93,41.33,132,58.67,225
DuPage,York 056,166,40.49,244,59.51,410
DuPage,York 062,224,42.26,306,57.74,530
DuPage,York 064,54,36.73,93,63.27,147
DuPage,York 074,243,42.19,333,57.81,576
DuPage,York 075,204,40.72,297,59.28,501
DuPage,York 077,145,38.98,227,61.02,372
DuPage,York 086,186,38.04,303,61.96,489
DuPage,York 093,151,39.53,231,60.47,382
DuPage,York 095,85,37.44,142,62.56,227
DuPage,York 097,178,35.46,324,64.54,502
DuPage,York 100,118,33.24,237,66.76,355
DuPage,York 101,90,34.48,171,65.52,261
DuPage,York 105,65,17.57,305,82.43,370
DuPage,York 106,56,16.77,278,83.23,334
DuPage,York 109,158,28.11,404,71.89,562
DuPage,York 111,213,42.01,294,57.99,507
DuPage,York 114,163,38.26,263,61.74,426
DuPage,York 119,58,17.74,269,82.26,327
DuPage,York 121,169,35.36,309,64.64,478
DuPage,York 122,46,17.76,213,82.24,259
DuPage,York 128,224,35.84,401,64.16,625
DuPage,York 130,80,28.57,200,71.43,280
Kane,DU0001,189,39.13,294,60.87,483
Kane,DU0002,105,39.18,163,60.82,268
Kane,DU0004,128,28.64,319,71.36,447
Kane,DU0016,180,41.57,253,58.43,433
Kane,DU0018,235,31.93,501,68.07,736
Kane,DU0020,173,28.45,435,71.55,608
Kane,DU0022,104,25.87,298,74.13,402
Kane,DU0023,128,44.91,157,55.09,285
Kane,DU0024,130,36.01,231,63.99,361
Kane,DU0025,88,26.19,248,73.81,336
Kane,DU0026,139,41.12,199,58.88,338
Kane,DU0027,100,37.88,164,62.12,264
Kane,DU0028,221,26.85,602,73.15,823
Kane,DU0029,106,29.04,259,70.96,365
Kane,DU0030,156,30.47,356,69.53,512
Kane,DU0031,78,28.47,196,71.53,274
Kane,DU0032,222,38.88,349,61.12,571
Kane,DU0033,212,39.63,323,60.37,535
Kane,DU0034,220,46.71,251,53.29,471
Kane,DU0035,213,44.47,266,55.53,479
Kane,EL0007,134,30.59,304,69.41,438
Kane,EL0008,177,47.84,193,52.16,370
Kane,EL0010,130,39.51,199,60.49,329
Kane,EL0015,145,44.62,180,55.38,325
Kane,EL0016,153,31.94,326,68.06,479
Kane,EL0021,109,42.25,149,57.75,258
Kane,EL0024,239,29.51,571,70.49,810
Kane,EL0036,169,41.32,240,58.68,409
Kane,EL0038,124,37.01,211,62.99,335
Kane,EL0039,89,34.77,167,65.23,256
Kane,EL0047,220,29.06,537,70.94,757
Kane,EL0048,236,42.14,324,57.86,560
Kane,EL0050,88,42.51,119,57.49,207
Kane,EL0051,139,32.55,288,67.45,427
Kane,EL0053,261,36.30,458,63.70,719
Kane,EL0054,189,44.37,237,55.63,426
Kane,EL0055,186,35.98,331,64.02,517
Kane,EL0056,184,43.19,242,56.81,426
Kane,EL0057,3,30.00,7,70.00,10
Kane,EL0058,287,37.57,477,62.43,764
Kane,EL0059,466,36.64,806,63.36,"1,272"
Kane,RU0001,209,28.67,520,71.33,729
Kane,RU0005,255,38.58,406,61.42,661
Kane,RU0006,113,30.46,258,69.54,371
Kane,SC0001,110,26.89,299,73.11,409
Kane,SC0002,144,27.38,382,72.62,526
Kane,SC0003,171,32.51,355,67.49,526
Kane,SC0007,104,19.37,433,80.63,537
Kane,SC0008,191,27.80,496,72.20,687
Kane,SC0011,134,35.36,245,64.64,379
Kane,SC0012,128,28.51,321,71.49,449
Kane,SC0016,129,21.36,475,78.64,604
Kane,SC0017,131,40.18,195,59.82,326
Kane,SC0022,150,25.64,435,74.36,585
Kane,SC0024,192,22.09,677,77.91,869
Kane,SC0026,156,22.91,525,77.09,681
Kane,SC0027,150,22.97,503,77.03,653
Kane,SC0028,143,26.24,402,73.76,545
Kane,SC0029,182,33.39,363,66.61,545
Kane,SC0030,144,25.44,422,74.56,566
Kane,SC0031,138,20.66,530,79.34,668
Kane,SC0032,71,14.88,406,85.12,477
Kane,SC0033,120,27.84,311,72.16,431
Lake,,0,0.00,0,0.00,0
Lake,Cuba 64,63,20.26,248,79.74,311
Lake,Cuba 65,118,20.59,455,79.41,573
Lake,Cuba 66,160,31.62,346,68.38,506
Lake,Cuba 67,104,26.40,290,73.60,394
Lake,Cuba 68,158,28.01,406,71.99,564
Lake,Cuba 69,185,27.69,483,72.31,668
Lake,Cuba 70,80,19.46,331,80.54,411
Lake,Cuba 71,124,24.80,376,75.20,500
Lake,Cuba 72,121,27.56,318,72.44,439
Lake,Cuba 73,137,26.50,380,73.50,517
Lake,Cuba 74,117,20.67,449,79.33,566
Lake,Cuba 75,92,20.96,347,79.04,439
Lake,Cuba 76,183,35.06,339,64.94,522
Lake,Cuba 77,147,21.84,526,78.16,673
Lake,Ela 100,146,21.82,523,78.18,669
Lake,Ela 101,169,25.61,491,74.39,660
Lake,Ela 102,158,21.56,575,78.44,733
Lake,Ela 103,181,33.64,357,66.36,538
Lake,Ela 104,132,22.41,457,77.59,589
Lake,Ela 105,161,25.88,461,74.12,622
Lake,Ela 78,87,20.42,339,79.58,426
Lake,Ela 79,127,25.10,379,74.90,506
Lake,Ela 80,140,25.59,407,74.41,547
Lake,Ela 81,168,28.57,420,71.43,588
Lake,Ela 82,156,27.96,402,72.04,558
Lake,Ela 83,211,38.72,334,61.28,545
Lake,Ela 84,118,34.71,222,65.29,340
Lake,Ela 85,98,27.76,255,72.24,353
Lake,Ela 86,152,26.67,418,73.33,570
Lake,Ela 87,230,40.35,340,59.65,570
Lake,Ela 88,90,18.71,391,81.29,481
Lake,Ela 89,129,25.15,384,74.85,513
Lake,Ela 90,156,30.95,348,69.05,504
Lake,Ela 91,139,32.55,288,67.45,427
Lake,Ela 92,153,34.38,292,65.62,445
Lake,Ela 93,174,36.71,300,63.29,474
Lake,Ela 94,187,37.47,312,62.53,499
Lake,Ela 95,175,34.05,339,65.95,514
Lake,Ela 96,168,30.60,381,69.40,549
Lake,Ela 97,167,35.38,305,64.62,472
Lake,Ela 98,107,23.78,343,76.22,450
Lake,Ela 99,190,24.45,587,75.55,777
McHenry,ALGONQUIN 1,89,40.45,131,59.55,220
McHenry,ALGONQUIN 10,194,48.50,206,51.50,400
McHenry,ALGONQUIN 11,172,44.22,217,55.78,389
McHenry,ALGONQUIN 12,152,38.19,246,61.81,398
McHenry,ALGONQUIN 13,127,39.20,197,60.80,324
McHenry,ALGONQUIN 14,111,30.66,251,69.34,362
McHenry,ALGONQUIN 15,98,37.98,160,62.02,258
McHenry,ALGONQUIN 16,119,24.44,368,75.56,487
McHenry,ALGONQUIN 17,146,24.62,447,75.38,593
McHenry,ALGONQUIN 18,98,36.16,173,63.84,271
McHenry,ALGONQUIN 19,108,38.16,175,61.84,283
McHenry,ALGONQUIN 2,163,43.82,209,56.18,372
McHenry,ALGONQUIN 20,59,33.71,116,66.29,175
McHenry,ALGONQUIN 21,157,41.53,221,58.47,378
McHenry,ALGONQUIN 22,95,41.13,136,58.87,231
McHenry,ALGONQUIN 23,153,29.82,360,70.18,513
McHenry,ALGONQUIN 24,151,43.14,199,56.86,350
McHenry,ALGONQUIN 25,109,42.08,150,57.92,259
McHenry,ALGONQUIN 26,97,38.04,158,61.96,255
McHenry,ALGONQUIN 27,106,34.30,203,65.70,309
McHenry,ALGONQUIN 28,143,36.48,249,63.52,392
McHenry,ALGONQUIN 29,91,38.08,148,61.92,239
McHenry,ALGONQUIN 3,109,39.21,169,60.79,278
McHenry,ALGONQUIN 30,156,30.95,348,69.05,504
McHenry,ALGONQUIN 31,176,35.99,313,64.01,489
McHenry,ALGONQUIN 32,123,37.61,204,62.39,327
McHenry,ALGONQUIN 33,162,32.93,330,67.07,492
McHenry,ALGONQUIN 34,140,43.61,181,56.39,321
McHenry,ALGONQUIN 35,167,40.14,249,59.86,416
McHenry,ALGONQUIN 36,118,30.65,267,69.35,385
McHenry,ALGONQUIN 37,49,50.52,48,49.48,97
McHenry,ALGONQUIN 38,155,41.01,223,58.99,378
McHenry,ALGONQUIN 39,131,42.67,176,57.33,307
McHenry,ALGONQUIN 4,189,46.90,214,53.10,403
McHenry,ALGONQUIN 40,142,48.97,148,51.03,290
McHenry,ALGONQUIN 41,216,39.78,327,60.22,543
McHenry,ALGONQUIN 42,180,33.64,355,66.36,535
McHenry,ALGONQUIN 43,147,32.38,307,67.62,454
McHenry,ALGONQUIN 44,130,36.31,228,63.69,358
McHenry,ALGONQUIN 45,136,28.75,337,71.25,473
McHenry,ALGONQUIN 46,179,33.65,353,66.35,532
McHenry,ALGONQUIN 47,205,34.11,396,65.89,601
McHenry,ALGONQUIN 48,170,30.52,387,69.48,557
McHenry,ALGONQUIN 49,105,27.56,276,72.44,381
McHenry,ALGONQUIN 5,172,36.44,300,63.56,472
McHenry,ALGONQUIN 50,148,32.03,314,67.97,462
McHenry,ALGONQUIN 51,214,36.83,367,63.17,581
McHenry,ALGONQUIN 52,169,41.94,234,58.06,403
McHenry,ALGONQUIN 53,106,43.80,136,56.20,242
McHenry,ALGONQUIN 54,143,32.06,303,67.94,446
McHenry,ALGONQUIN 55,170,34.62,321,65.38,491
McHenry,ALGONQUIN 56,121,41.72,169,58.28,290
McHenry,ALGONQUIN 57,204,40.32,302,59.68,506
McHenry,ALGONQUIN 58,162,33.68,319,66.32,481
McHenry,ALGONQUIN 59,201,45.17,244,54.83,445
McHenry,ALGONQUIN 6,124,35.63,224,64.37,348
McHenry,ALGONQUIN 60,77,35.98,137,64.02,214
McHenry,ALGONQUIN 61,105,37.50,175,62.50,280
McHenry,ALGONQUIN 62,166,34.66,313,65.34,479
McHenry,ALGONQUIN 63,181,34.67,341,65.33,522
McHenry,ALGONQUIN 64,80,28.78,198,71.22,278
McHenry,ALGONQUIN 65,143,24.20,448,75.80,591
McHenry,ALGONQUIN 66,110,35.26,202,64.74,312
McHenry,ALGONQUIN 67,104,22.96,349,77.04,453
McHenry,ALGONQUIN 68,177,28.55,443,71.45,620
McHenry,ALGONQUIN 7,84,33.60,166,66.40,250
McHenry,ALGONQUIN 8,149,36.88,255,63.12,404
McHenry,ALGONQUIN 9,128,34.97,238,65.03,366
TOTAL:,,"78,465",32.86,"160,287",67.14,"238,752"