County,Precinct,ROBERT MARSHALL,ROBERT MARSHALL PERCENT,AMANDA HOWLAND,AMANDA HOWLAND PERCENT,Total
Cook,7000001,30,23.81%,96,76.19%,126
Cook,7000002,45,27.44%,119,72.56%,164
Cook,7000003,38,42.22%,52,57.78%,90
Cook,7000005,22,26.83%,60,73.17%,82
Cook,7000006,56,31.46%,122,68.54%,178
Cook,7000007,12,28.57%,30,71.43%,42
Cook,7000008,57,38.00%,93,62.00%,150
Cook,7000009,26,24.53%,80,75.47%,106
Cook,7000010,55,37.41%,92,62.59%,147
Cook,7600009,63,32.31%,132,67.69%,195
Cook,7600026,111,48.90%,116,51.10%,227
Cook,7600031,31,31.00%,69,69.00%,100
Cook,7600042,55,43.31%,72,56.69%,127
Cook,7600044,44,36.97%,75,63.03%,119
Cook,7900012,44,53.66%,38,46.34%,82
Cook,7900027,18,37.50%,30,62.50%,48
Cook,8700001,49,33.11%,99,66.89%,148
Cook,8700002,67,34.54%,127,65.46%,194
Cook,8700003,29,31.52%,63,68.48%,92
Cook,8700006,66,33.67%,130,66.33%,196
Cook,8700007,69,37.70%,114,62.30%,183
Cook,8700008,64,31.84%,137,68.16%,201
Cook,8700009,43,31.62%,93,68.38%,136
Cook,8700010,38,31.15%,84,68.85%,122
Cook,8700011,55,35.26%,101,64.74%,156
Cook,8700012,31,26.72%,85,73.28%,116
Cook,8700014,52,30.95%,116,69.05%,168
Cook,8700015,67,34.36%,128,65.64%,195
Cook,8700017,61,32.80%,125,67.20%,186
Cook,8700018,61,45.19%,74,54.81%,135
Cook,8700019,57,36.31%,100,63.69%,157
Cook,8700020,81,40.30%,120,59.70%,201
Cook,8700023,18,24.66%,55,75.34%,73
Cook,8700025,47,35.07%,87,64.93%,134
Cook,8700028,47,31.97%,100,68.03%,147
Cook,8700029,80,39.22%,124,60.78%,204
Cook,8700030,51,36.96%,87,63.04%,138
Cook,8700031,30,26.09%,85,73.91%,115
Cook,8700032,53,36.81%,91,63.19%,144
Cook,8700033,39,29.32%,94,70.68%,133
Cook,8700034,72,35.64%,130,64.36%,202
Cook,8700035,52,31.52%,113,68.48%,165
Cook,8700036,48,31.79%,103,68.21%,151
Cook,8700037,79,39.30%,122,60.70%,201
Cook,8700038,36,31.86%,77,68.14%,113
Cook,8700040,70,34.65%,132,65.35%,202
Cook,8700041,53,25.85%,152,74.15%,205
Cook,8700042,77,34.38%,147,65.63%,224
Cook,8700043,54,40.91%,78,59.09%,132
Cook,8700044,32,30.48%,73,69.52%,105
Cook,8700045,51,41.80%,71,58.20%,122
Cook,8700046,77,40.53%,113,59.47%,190
Cook,8700048,38,34.23%,73,65.77%,111
Cook,8700049,23,27.38%,61,72.62%,84
Cook,8700050,75,31.65%,162,68.35%,237
Cook,8700051,0,0.00%,0,0.00%,0
Cook,8700052,40,35.40%,73,64.60%,113
Cook,8700054,74,33.33%,148,66.67%,222
Cook,8700055,31,31.00%,69,69.00%,100
Cook,8700056,68,38.86%,107,61.14%,175
Cook,8700057,84,34.01%,163,65.99%,247
Cook,8700063,67,37.85%,110,62.15%,177
Cook,8700064,66,33.67%,130,66.33%,196
Cook,8700065,49,36.03%,87,63.97%,136
Cook,8700067,33,34.02%,64,65.98%,97
Cook,8700068,49,37.40%,82,62.60%,131
Cook,8700069,55,34.38%,105,65.63%,160
DuPage,Bloomingdale 009,39,31.71%,84,68.29%,123
DuPage,Bloomingdale 018,35,31.82%,75,68.18%,110
DuPage,Bloomingdale 043,45,38.14%,73,61.86%,118
DuPage,Bloomingdale 045,26,43.33%,34,56.67%,60
DuPage,Bloomingdale 058,55,33.95%,107,66.05%,162
DuPage,Bloomingdale 068,42,34.71%,79,65.29%,121
DuPage,Bloomingdale 077,43,38.05%,70,61.95%,113
DuPage,Bloomingdale 080,29,35.37%,53,64.63%,82
DuPage,Bloomingdale 089,25,25.00%,75,75.00%,100
DuPage,Downers Grove 002,32,24.06%,101,75.94%,133
DuPage,Downers Grove 003,47,30.13%,109,69.87%,156
DuPage,Downers Grove 006,30,38.96%,47,61.04%,77
DuPage,Downers Grove 007,29,31.52%,63,68.48%,92
DuPage,Downers Grove 008,41,27.52%,108,72.48%,149
DuPage,Downers Grove 009,34,24.46%,105,75.54%,139
DuPage,Downers Grove 010,74,37.76%,122,62.24%,196
DuPage,Downers Grove 011,45,36.89%,77,63.11%,122
DuPage,Downers Grove 012,32,23.70%,103,76.30%,135
DuPage,Downers Grove 014,50,33.11%,101,66.89%,151
DuPage,Downers Grove 015,40,35.40%,73,64.60%,113
DuPage,Downers Grove 016,20,29.41%,48,70.59%,68
DuPage,Downers Grove 017,36,26.87%,98,73.13%,134
DuPage,Downers Grove 018,55,30.05%,128,69.95%,183
DuPage,Downers Grove 019,38,38.00%,62,62.00%,100
DuPage,Downers Grove 020,53,27.04%,143,72.96%,196
DuPage,Downers Grove 021,39,28.06%,100,71.94%,139
DuPage,Downers Grove 026,36,28.35%,91,71.65%,127
DuPage,Downers Grove 027,28,36.36%,49,63.64%,77
DuPage,Downers Grove 028,19,28.36%,48,71.64%,67
DuPage,Downers Grove 029,27,28.42%,68,71.58%,95
DuPage,Downers Grove 030,42,32.81%,86,67.19%,128
DuPage,Downers Grove 031,47,32.64%,97,67.36%,144
DuPage,Downers Grove 032,28,30.43%,64,69.57%,92
DuPage,Downers Grove 033,52,40.94%,75,59.06%,127
DuPage,Downers Grove 034,60,30.61%,136,69.39%,196
DuPage,Downers Grove 036,36,27.91%,93,72.09%,129
DuPage,Downers Grove 037,46,36.22%,81,63.78%,127
DuPage,Downers Grove 038,26,29.55%,62,70.45%,88
DuPage,Downers Grove 039,38,32.20%,80,67.80%,118
DuPage,Downers Grove 044,29,39.73%,44,60.27%,73
DuPage,Downers Grove 045,25,22.73%,85,77.27%,110
DuPage,Downers Grove 047,25,38.46%,40,61.54%,65
DuPage,Downers Grove 048,25,26.88%,68,73.12%,93
DuPage,Downers Grove 049,47,29.19%,114,70.81%,161
DuPage,Downers Grove 050,45,29.61%,107,70.39%,152
DuPage,Downers Grove 051,57,43.18%,75,56.82%,132
DuPage,Downers Grove 052,41,33.61%,81,66.39%,122
DuPage,Downers Grove 053,49,30.63%,111,69.38%,160
DuPage,Downers Grove 054,41,26.45%,114,73.55%,155
DuPage,Downers Grove 055,25,36.23%,44,63.77%,69
DuPage,Downers Grove 056,34,36.56%,59,63.44%,93
DuPage,Downers Grove 057,48,36.92%,82,63.08%,130
DuPage,Downers Grove 059,35,35.35%,64,64.65%,99
DuPage,Downers Grove 061,56,41.48%,79,58.52%,135
DuPage,Downers Grove 063,34,35.05%,63,64.95%,97
DuPage,Downers Grove 064,50,27.93%,129,72.07%,179
DuPage,Downers Grove 065,27,23.08%,90,76.92%,117
DuPage,Downers Grove 066,33,33.67%,65,66.33%,98
DuPage,Downers Grove 067,49,32.45%,102,67.55%,151
DuPage,Downers Grove 069,32,32.00%,68,68.00%,100
DuPage,Downers Grove 070,48,28.24%,122,71.76%,170
DuPage,Downers Grove 071,65,43.33%,85,56.67%,150
DuPage,Downers Grove 073,25,28.74%,62,71.26%,87
DuPage,Downers Grove 074,60,39.74%,91,60.26%,151
DuPage,Downers Grove 075,34,26.77%,93,73.23%,127
DuPage,Downers Grove 076,72,38.10%,117,61.90%,189
DuPage,Downers Grove 078,30,31.91%,64,68.09%,94
DuPage,Downers Grove 079,52,32.10%,110,67.90%,162
DuPage,Downers Grove 082,29,27.36%,77,72.64%,106
DuPage,Downers Grove 083,27,27.55%,71,72.45%,98
DuPage,Downers Grove 084,25,22.94%,84,77.06%,109
DuPage,Downers Grove 085,23,26.74%,63,73.26%,86
DuPage,Downers Grove 087,49,32.67%,101,67.33%,150
DuPage,Downers Grove 092,24,22.22%,84,77.78%,108
DuPage,Downers Grove 094,56,37.84%,92,62.16%,148
DuPage,Downers Grove 096,42,27.10%,113,72.90%,155
DuPage,Downers Grove 097,45,37.50%,75,62.50%,120
DuPage,Downers Grove 098,33,31.43%,72,68.57%,105
DuPage,Downers Grove 102,36,41.86%,50,58.14%,86
DuPage,Downers Grove 103,26,31.33%,57,68.67%,83
DuPage,Downers Grove 105,59,33.15%,119,66.85%,178
DuPage,Downers Grove 106,38,33.93%,74,66.07%,112
DuPage,Downers Grove 107,24,30.00%,56,70.00%,80
DuPage,Downers Grove 109,55,42.64%,74,57.36%,129
DuPage,Downers Grove 112,44,34.92%,82,65.08%,126
DuPage,Downers Grove 113,32,32.65%,66,67.35%,98
DuPage,Downers Grove 115,55,40.74%,80,59.26%,135
DuPage,Downers Grove 118,54,31.21%,119,68.79%,173
DuPage,Downers Grove 119,32,37.65%,53,62.35%,85
DuPage,Downers Grove 120,58,32.58%,120,67.42%,178
DuPage,Downers Grove 121,40,34.19%,77,65.81%,117
DuPage,Downers Grove 127,38,29.69%,90,70.31%,128
DuPage,Downers Grove 129,49,34.51%,93,65.49%,142
DuPage,Downers Grove 130,66,44.30%,83,55.70%,149
DuPage,Downers Grove 131,46,36.51%,80,63.49%,126
DuPage,Downers Grove 132,27,36.99%,46,63.01%,73
DuPage,Downers Grove 140,33,36.67%,57,63.33%,90
DuPage,Downers Grove 141,18,32.73%,37,67.27%,55
DuPage,Downers Grove 142,32,36.36%,56,63.64%,88
DuPage,Lisle 001,55,31.07%,122,68.93%,177
DuPage,Lisle 003,18,22.50%,62,77.50%,80
DuPage,Lisle 004,37,27.82%,96,72.18%,133
DuPage,Lisle 006,8,11.76%,60,88.24%,68
DuPage,Lisle 007,22,30.99%,49,69.01%,71
DuPage,Lisle 008,59,36.65%,102,63.35%,161
DuPage,Lisle 009,39,36.45%,68,63.55%,107
DuPage,Lisle 011,44,32.84%,90,67.16%,134
DuPage,Lisle 014,24,24.74%,73,75.26%,97
DuPage,Lisle 016,28,28.57%,70,71.43%,98
DuPage,Lisle 022,33,28.70%,82,71.30%,115
DuPage,Lisle 025,23,21.30%,85,78.70%,108
DuPage,Lisle 031,38,32.48%,79,67.52%,117
DuPage,Lisle 032,52,37.14%,88,62.86%,140
DuPage,Lisle 037,29,26.36%,81,73.64%,110
DuPage,Lisle 038,65,40.12%,97,59.88%,162
DuPage,Lisle 040,36,30.00%,84,70.00%,120
DuPage,Lisle 043,33,35.87%,59,64.13%,92
DuPage,Lisle 044,33,34.38%,63,65.63%,96
DuPage,Lisle 052,44,32.35%,92,67.65%,136
DuPage,Lisle 055,32,29.09%,78,70.91%,110
DuPage,Lisle 056,39,39.39%,60,60.61%,99
DuPage,Lisle 059,43,31.62%,93,68.38%,136
DuPage,Lisle 061,40,31.01%,89,68.99%,129
DuPage,Lisle 068,40,34.78%,75,65.22%,115
DuPage,Lisle 077,29,34.52%,55,65.48%,84
DuPage,Lisle 078,40,28.99%,98,71.01%,138
DuPage,Lisle 080,37,34.26%,71,65.74%,108
DuPage,Lisle 081,29,29.00%,71,71.00%,100
DuPage,Lisle 083,43,31.85%,92,68.15%,135
DuPage,Lisle 088,20,22.99%,67,77.01%,87
DuPage,Lisle 089,64,35.16%,118,64.84%,182
DuPage,Lisle 091,47,31.54%,102,68.46%,149
DuPage,Lisle 092,18,26.09%,51,73.91%,69
DuPage,Lisle 095,23,25.56%,67,74.44%,90
DuPage,Lisle 100,24,31.17%,53,68.83%,77
DuPage,Lisle 101,31,26.96%,84,73.04%,115
DuPage,Lisle 104,21,34.43%,40,65.57%,61
DuPage,Lisle 106,17,24.29%,53,75.71%,70
DuPage,Lisle 107,24,26.97%,65,73.03%,89
DuPage,Lisle 111,52,28.11%,133,71.89%,185
DuPage,Lisle 112,44,25.43%,129,74.57%,173
DuPage,Lisle 114,35,35.00%,65,65.00%,100
DuPage,Milton 001,14,15.22%,78,84.78%,92
DuPage,Milton 002,33,26.40%,92,73.60%,125
DuPage,Milton 003,26,29.55%,62,70.45%,88
DuPage,Milton 004,34,33.66%,67,66.34%,101
DuPage,Milton 005,60,48.39%,64,51.61%,124
DuPage,Milton 006,37,29.84%,87,70.16%,124
DuPage,Milton 007,22,22.92%,74,77.08%,96
DuPage,Milton 008,32,26.89%,87,73.11%,119
DuPage,Milton 009,15,18.75%,65,81.25%,80
DuPage,Milton 010,28,24.35%,87,75.65%,115
DuPage,Milton 011,28,26.42%,78,73.58%,106
DuPage,Milton 012,34,32.69%,70,67.31%,104
DuPage,Milton 013,27,27.55%,71,72.45%,98
DuPage,Milton 014,21,27.63%,55,72.37%,76
DuPage,Milton 015,26,23.42%,85,76.58%,111
DuPage,Milton 016,20,25.32%,59,74.68%,79
DuPage,Milton 017,26,32.10%,55,67.90%,81
DuPage,Milton 018,45,36.00%,80,64.00%,125
DuPage,Milton 019,41,28.28%,104,71.72%,145
DuPage,Milton 020,37,28.91%,91,71.09%,128
DuPage,Milton 021,31,29.25%,75,70.75%,106
DuPage,Milton 022,29,32.58%,60,67.42%,89
DuPage,Milton 023,47,35.61%,85,64.39%,132
DuPage,Milton 024,52,38.52%,83,61.48%,135
DuPage,Milton 025,25,32.05%,53,67.95%,78
DuPage,Milton 026,53,34.19%,102,65.81%,155
DuPage,Milton 027,40,33.06%,81,66.94%,121
DuPage,Milton 028,41,37.61%,68,62.39%,109
DuPage,Milton 029,19,21.84%,68,78.16%,87
DuPage,Milton 030,34,39.08%,53,60.92%,87
DuPage,Milton 031,19,27.94%,49,72.06%,68
DuPage,Milton 032,44,33.33%,88,66.67%,132
DuPage,Milton 033,35,33.02%,71,66.98%,106
DuPage,Milton 034,51,32.28%,107,67.72%,158
DuPage,Milton 035,35,27.13%,94,72.87%,129
DuPage,Milton 036,45,30.41%,103,69.59%,148
DuPage,Milton 037,22,24.18%,69,75.82%,91
DuPage,Milton 038,58,34.32%,111,65.68%,169
DuPage,Milton 039,35,37.23%,59,62.77%,94
DuPage,Milton 040,49,34.27%,94,65.73%,143
DuPage,Milton 041,44,33.08%,89,66.92%,133
DuPage,Milton 042,40,32.00%,85,68.00%,125
DuPage,Milton 043,26,23.21%,86,76.79%,112
DuPage,Milton 044,33,35.48%,60,64.52%,93
DuPage,Milton 045,30,28.04%,77,71.96%,107
DuPage,Milton 046,32,30.77%,72,69.23%,104
DuPage,Milton 047,69,39.88%,104,60.12%,173
DuPage,Milton 048,35,27.56%,92,72.44%,127
DuPage,Milton 049,40,37.38%,67,62.62%,107
DuPage,Milton 050,54,35.53%,98,64.47%,152
DuPage,Milton 051,11,21.15%,41,78.85%,52
DuPage,Milton 052,26,26.00%,74,74.00%,100
DuPage,Milton 054,31,29.52%,74,70.48%,105
DuPage,Milton 055,38,30.40%,87,69.60%,125
DuPage,Milton 056,51,29.14%,124,70.86%,175
DuPage,Milton 057,34,29.82%,80,70.18%,114
DuPage,Milton 058,41,30.37%,94,69.63%,135
DuPage,Milton 059,17,17.35%,81,82.65%,98
DuPage,Milton 060,18,21.43%,66,78.57%,84
DuPage,Milton 061,22,33.33%,44,66.67%,66
DuPage,Milton 062,30,29.41%,72,70.59%,102
DuPage,Milton 063,49,39.84%,74,60.16%,123
DuPage,Milton 064,40,30.53%,91,69.47%,131
DuPage,Milton 065,30,26.09%,85,73.91%,115
DuPage,Milton 066,30,21.74%,108,78.26%,138
DuPage,Milton 067,27,30.68%,61,69.32%,88
DuPage,Milton 068,36,29.03%,88,70.97%,124
DuPage,Milton 069,35,29.41%,84,70.59%,119
DuPage,Milton 071,24,28.57%,60,71.43%,84
DuPage,Milton 073,34,31.78%,73,68.22%,107
DuPage,Milton 074,37,35.92%,66,64.08%,103
DuPage,Milton 075,34,34.69%,64,65.31%,98
DuPage,Milton 076,43,30.71%,97,69.29%,140
DuPage,Milton 077,25,35.21%,46,64.79%,71
DuPage,Milton 078,44,30.34%,101,69.66%,145
DuPage,Milton 079,36,35.29%,66,64.71%,102
DuPage,Milton 080,28,27.45%,74,72.55%,102
DuPage,Milton 081,29,34.52%,55,65.48%,84
DuPage,Milton 082,20,28.99%,49,71.01%,69
DuPage,Milton 083,32,26.23%,90,73.77%,122
DuPage,Milton 084,43,32.33%,90,67.67%,133
DuPage,Milton 085,34,28.33%,86,71.67%,120
DuPage,Milton 086,49,36.30%,86,63.70%,135
DuPage,Milton 087,22,27.85%,57,72.15%,79
DuPage,Milton 088,46,31.29%,101,68.71%,147
DuPage,Milton 089,37,31.62%,80,68.38%,117
DuPage,Milton 090,50,39.37%,77,60.63%,127
DuPage,Milton 091,25,28.09%,64,71.91%,89
DuPage,Milton 092,37,31.09%,82,68.91%,119
DuPage,Milton 093,40,40.40%,59,59.60%,99
DuPage,Milton 094,41,31.30%,90,68.70%,131
DuPage,Milton 095,19,22.09%,67,77.91%,86
DuPage,Milton 096,31,28.44%,78,71.56%,109
DuPage,Milton 097,47,31.97%,100,68.03%,147
DuPage,Milton 098,37,38.14%,60,61.86%,97
DuPage,Milton 099,31,28.18%,79,71.82%,110
DuPage,Milton 100,25,29.41%,60,70.59%,85
DuPage,Milton 102,19,31.67%,41,68.33%,60
DuPage,Milton 104,43,33.33%,86,66.67%,129
DuPage,Milton 105,22,28.21%,56,71.79%,78
DuPage,Milton 106,25,36.23%,44,63.77%,69
DuPage,Milton 107,30,30.30%,69,69.70%,99
DuPage,Milton 108,35,39.77%,53,60.23%,88
DuPage,Milton 109,17,22.97%,57,77.03%,74
DuPage,Milton 110,36,40.00%,54,60.00%,90
DuPage,Milton 111,40,30.08%,93,69.92%,133
DuPage,Milton 112,18,29.51%,43,70.49%,61
DuPage,Milton 113,20,25.00%,60,75.00%,80
DuPage,Milton 114,33,36.67%,57,63.33%,90
DuPage,Milton 115,29,34.52%,55,65.48%,84
DuPage,Milton 116,24,31.58%,52,68.42%,76
DuPage,Milton 119,14,30.43%,32,69.57%,46
DuPage,Milton 120,33,43.42%,43,56.58%,76
DuPage,Milton 122,25,27.17%,67,72.83%,92
DuPage,Milton 123,40,39.22%,62,60.78%,102
DuPage,Milton 124,13,25.00%,39,75.00%,52
DuPage,Naperville 004,13,26.00%,37,74.00%,50
DuPage,Naperville 005,29,28.43%,73,71.57%,102
DuPage,Naperville 007,38,31.15%,84,68.85%,122
DuPage,Naperville 010,48,34.53%,91,65.47%,139
DuPage,Naperville 015,47,36.15%,83,63.85%,130
DuPage,Naperville 016,2,6.06%,31,93.94%,33
DuPage,Naperville 019,47,31.97%,100,68.03%,147
DuPage,Naperville 022,61,35.06%,113,64.94%,174
DuPage,Naperville 026,56,36.36%,98,63.64%,154
DuPage,Naperville 031,63,38.65%,100,61.35%,163
DuPage,Naperville 061,35,30.43%,80,69.57%,115
DuPage,Naperville 084,28,35.90%,50,64.10%,78
DuPage,Wayne 001,18,23.08%,60,76.92%,78
DuPage,Wayne 002,42,38.89%,66,61.11%,108
DuPage,Wayne 003,16,33.33%,32,66.67%,48
DuPage,Wayne 004,53,41.41%,75,58.59%,128
DuPage,Wayne 005,39,34.82%,73,65.18%,112
DuPage,Wayne 006,45,35.43%,82,64.57%,127
DuPage,Wayne 007,39,42.39%,53,57.61%,92
DuPage,Wayne 008,31,42.47%,42,57.53%,73
DuPage,Wayne 009,52,40.31%,77,59.69%,129
DuPage,Wayne 010,22,40.00%,33,60.00%,55
DuPage,Wayne 011,19,21.84%,68,78.16%,87
DuPage,Wayne 012,32,31.68%,69,68.32%,101
DuPage,Wayne 013,44,41.12%,63,58.88%,107
DuPage,Wayne 015,53,34.64%,100,65.36%,153
DuPage,Wayne 017,53,40.15%,79,59.85%,132
DuPage,Wayne 019,51,39.23%,79,60.77%,130
DuPage,Wayne 020,29,25.00%,87,75.00%,116
DuPage,Wayne 021,48,39.02%,75,60.98%,123
DuPage,Wayne 022,36,37.50%,60,62.50%,96
DuPage,Wayne 023,47,34.56%,89,65.44%,136
DuPage,Wayne 025,28,24.78%,85,75.22%,113
DuPage,Wayne 026,30,33.71%,59,66.29%,89
DuPage,Wayne 028,33,42.86%,44,57.14%,77
DuPage,Wayne 030,48,35.82%,86,64.18%,134
DuPage,Wayne 032,23,31.51%,50,68.49%,73
DuPage,Wayne 033,33,33.00%,67,67.00%,100
DuPage,Wayne 035,15,22.73%,51,77.27%,66
DuPage,Wayne 036,37,33.33%,74,66.67%,111
DuPage,Wayne 037,28,31.82%,60,68.18%,88
DuPage,Wayne 038,10,41.67%,14,58.33%,24
DuPage,Wayne 039,43,34.68%,81,65.32%,124
DuPage,Wayne 040,32,33.68%,63,66.32%,95
DuPage,Wayne 042,45,44.55%,56,55.45%,101
DuPage,Wayne 043,28,32.94%,57,67.06%,85
DuPage,Wayne 044,26,32.50%,54,67.50%,80
DuPage,Wayne 046,27,34.62%,51,65.38%,78
DuPage,Wayne 047,45,53.57%,39,46.43%,84
DuPage,Wayne 048,33,34.74%,62,65.26%,95
DuPage,Wayne 049,55,46.61%,63,53.39%,118
DuPage,Wayne 050,51,42.86%,68,57.14%,119
DuPage,Wayne 052,29,32.22%,61,67.78%,90
DuPage,Wayne 053,55,38.46%,88,61.54%,143
DuPage,Wayne 054,61,43.26%,80,56.74%,141
DuPage,Wayne 055,28,31.11%,62,68.89%,90
DuPage,Wayne 056,17,34.69%,32,65.31%,49
DuPage,Wayne 057,36,35.64%,65,64.36%,101
DuPage,Wayne 058,25,31.65%,54,68.35%,79
DuPage,Wayne 059,31,33.33%,62,66.67%,93
DuPage,Wayne 060,24,35.82%,43,64.18%,67
DuPage,Winfield 001,63,39.13%,98,60.87%,161
DuPage,Winfield 002,55,34.16%,106,65.84%,161
DuPage,Winfield 004,49,31.21%,108,68.79%,157
DuPage,Winfield 005,41,33.61%,81,66.39%,122
DuPage,Winfield 006,35,33.98%,68,66.02%,103
DuPage,Winfield 007,29,33.72%,57,66.28%,86
DuPage,Winfield 008,17,25.00%,51,75.00%,68
DuPage,Winfield 009,110,52.13%,101,47.87%,211
DuPage,Winfield 012,65,39.16%,101,60.84%,166
DuPage,Winfield 013,58,43.94%,74,56.06%,132
DuPage,Winfield 014,60,37.74%,99,62.26%,159
DuPage,Winfield 015,25,20.66%,96,79.34%,121
DuPage,Winfield 017,39,33.05%,79,66.95%,118
DuPage,Winfield 018,32,37.21%,54,62.79%,86
DuPage,Winfield 019,31,34.44%,59,65.56%,90
DuPage,Winfield 020,40,35.71%,72,64.29%,112
DuPage,Winfield 021,56,31.11%,124,68.89%,180
DuPage,Winfield 022,50,32.89%,102,67.11%,152
DuPage,Winfield 023,46,35.66%,83,64.34%,129
DuPage,Winfield 030,43,28.86%,106,71.14%,149
DuPage,Winfield 037,43,39.81%,65,60.19%,108
DuPage,York 003,22,28.95%,54,71.05%,76
DuPage,York 009,61,36.31%,107,63.69%,168
DuPage,York 018,41,30.15%,95,69.85%,136
DuPage,York 019,7,63.64%,4,36.36%,11
DuPage,York 021,35,26.92%,95,73.08%,130
DuPage,York 026,41,31.06%,91,68.94%,132
DuPage,York 030,28,32.56%,58,67.44%,86
DuPage,York 036,35,36.46%,61,63.54%,96
DuPage,York 042,44,36.07%,78,63.93%,122
DuPage,York 043,31,36.47%,54,63.53%,85
DuPage,York 045,8,38.10%,13,61.90%,21
DuPage,York 046,44,34.38%,84,65.63%,128
DuPage,York 056,64,34.97%,119,65.03%,183
DuPage,York 062,52,32.70%,107,67.30%,159
DuPage,York 064,25,29.07%,61,70.93%,86
DuPage,York 074,52,31.14%,115,68.86%,167
DuPage,York 075,47,31.97%,100,68.03%,147
DuPage,York 077,34,29.57%,81,70.43%,115
DuPage,York 086,48,30.19%,111,69.81%,159
DuPage,York 092,38,32.48%,79,67.52%,117
DuPage,York 093,36,45.00%,44,55.00%,80
DuPage,York 095,30,28.04%,77,71.96%,107
DuPage,York 097,44,34.38%,84,65.63%,128
DuPage,York 100,48,36.09%,85,63.91%,133
DuPage,York 101,26,26.80%,71,73.20%,97
DuPage,York 105,14,40.00%,21,60.00%,35
DuPage,York 106,13,39.39%,20,60.61%,33
DuPage,York 109,16,21.62%,58,78.38%,74
DuPage,York 111,64,34.97%,119,65.03%,183
DuPage,York 114,51,34.93%,95,65.07%,146
DuPage,York 118,41,45.56%,49,54.44%,90
DuPage,York 119,14,31.11%,31,68.89%,45
DuPage,York 121,64,35.96%,114,64.04%,178
DuPage,York 122,28,36.36%,49,63.64%,77
DuPage,York 123,40,33.90%,78,66.10%,118
DuPage,York 128,46,37.10%,78,62.90%,124
DuPage,York 130,18,22.50%,62,77.50%,80
DuPage,York 131,16,34.04%,31,65.96%,47
Kane,DU0001,53,35.33%,97,64.67%,150
Kane,DU0002,33,33.67%,65,66.33%,98
Kane,DU0004,46,37.70%,76,62.30%,122
Kane,DU0016,73,37.44%,122,62.56%,195
Kane,DU0018,75,35.89%,134,64.11%,209
Kane,DU0020,51,36.96%,87,63.04%,138
Kane,DU0022,42,39.25%,65,60.75%,107
Kane,DU0023,32,30.48%,73,69.52%,105
Kane,DU0024,52,40.31%,77,59.69%,129
Kane,DU0025,13,18.06%,59,81.94%,72
Kane,DU0026,40,35.40%,73,64.60%,113
Kane,DU0027,39,36.79%,67,63.21%,106
Kane,DU0028,66,34.74%,124,65.26%,190
Kane,DU0029,36,30.51%,82,69.49%,118
Kane,DU0030,76,40.64%,111,59.36%,187
Kane,DU0031,40,42.55%,54,57.45%,94
Kane,DU0032,101,43.16%,133,56.84%,234
Kane,DU0033,98,38.43%,157,61.57%,255
Kane,DU0034,78,40.00%,117,60.00%,195
Kane,DU0035,110,40.89%,159,59.11%,269
Kane,EL0007,36,30.25%,83,69.75%,119
Kane,EL0008,48,36.36%,84,63.64%,132
Kane,EL0010,39,35.14%,72,64.86%,111
Kane,EL0015,53,35.81%,95,64.19%,148
Kane,EL0016,44,31.21%,97,68.79%,141
Kane,EL0021,49,45.79%,58,54.21%,107
Kane,EL0024,60,29.70%,142,70.30%,202
Kane,EL0036,69,40.59%,101,59.41%,170
Kane,EL0038,49,48.04%,53,51.96%,102
Kane,EL0039,31,35.23%,57,64.77%,88
Kane,EL0047,84,36.05%,149,63.95%,233
Kane,EL0048,80,43.01%,106,56.99%,186
Kane,EL0050,31,33.70%,61,66.30%,92
Kane,EL0051,58,44.96%,71,55.04%,129
Kane,EL0053,106,36.43%,185,63.57%,291
Kane,EL0054,63,40.91%,91,59.09%,154
Kane,EL0055,77,42.08%,106,57.92%,183
Kane,EL0056,63,38.41%,101,61.59%,164
Kane,EL0057,0,0.00%,2,100.00%,2
Kane,EL0058,108,39.85%,163,60.15%,271
Kane,EL0059,132,36.36%,231,63.64%,363
Kane,RU0001,77,40.10%,115,59.90%,192
Kane,RU0005,95,39.42%,146,60.58%,241
Kane,RU0006,29,34.94%,54,65.06%,83
Kane,SC0001,23,31.51%,50,68.49%,73
Kane,SC0002,36,31.58%,78,68.42%,114
Kane,SC0003,51,32.69%,105,67.31%,156
Kane,SC0007,22,28.57%,55,71.43%,77
Kane,SC0008,59,34.91%,110,65.09%,169
Kane,SC0011,56,40.88%,81,59.12%,137
Kane,SC0012,54,40.60%,79,59.40%,133
Kane,SC0016,38,30.65%,86,69.35%,124
Kane,SC0017,52,42.62%,70,57.38%,122
Kane,SC0022,32,31.68%,69,68.32%,101
Kane,SC0024,69,33.01%,140,66.99%,209
Kane,SC0026,39,35.14%,72,64.86%,111
Kane,SC0027,37,31.09%,82,68.91%,119
Kane,SC0028,34,31.19%,75,68.81%,109
Kane,SC0029,53,33.76%,104,66.24%,157
Kane,SC0030,31,26.50%,86,73.50%,117
Kane,SC0031,38,34.55%,72,65.45%,110
Kane,SC0032,18,30.51%,41,69.49%,59
Kane,SC0033,29,27.62%,76,72.38%,105
Lake,Cuba 64,12,19.67%,49,80.33%,61
Lake,Cuba 65,24,23.08%,80,76.92%,104
Lake,Cuba 66,34,27.64%,89,72.36%,123
Lake,Cuba 67,30,29.13%,73,70.87%,103
Lake,Cuba 68,37,28.24%,94,71.76%,131
Lake,Cuba 69,39,21.55%,142,78.45%,181
Lake,Cuba 70,17,20.99%,64,79.01%,81
Lake,Cuba 71,35,33.65%,69,66.35%,104
Lake,Cuba 72,27,25.47%,79,74.53%,106
Lake,Cuba 73,38,29.92%,89,70.08%,127
Lake,Cuba 74,34,30.91%,76,69.09%,110
Lake,Cuba 75,7,10.61%,59,89.39%,66
Lake,Cuba 76,46,28.05%,118,71.95%,164
Lake,Cuba 77,27,23.48%,88,76.52%,115
Lake,Ela 100,47,30.92%,105,69.08%,152
Lake,Ela 101,44,26.99%,119,73.01%,163
Lake,Ela 102,29,21.01%,109,78.99%,138
Lake,Ela 103,50,30.67%,113,69.33%,163
Lake,Ela 104,36,30.25%,83,69.75%,119
Lake,Ela 105,29,22.48%,100,77.52%,129
Lake,Ela 78,18,20.00%,72,80.00%,90
Lake,Ela 79,52,38.52%,83,61.48%,135
Lake,Ela 80,40,26.67%,110,73.33%,150
Lake,Ela 81,41,26.80%,112,73.20%,153
Lake,Ela 82,38,25.68%,110,74.32%,148
Lake,Ela 83,49,26.20%,138,73.80%,187
Lake,Ela 84,36,27.27%,96,72.73%,132
Lake,Ela 85,28,28.87%,69,71.13%,97
Lake,Ela 86,38,26.57%,105,73.43%,143
Lake,Ela 87,56,27.86%,145,72.14%,201
Lake,Ela 88,24,29.27%,58,70.73%,82
Lake,Ela 89,36,25.90%,103,74.10%,139
Lake,Ela 90,29,19.33%,121,80.67%,150
Lake,Ela 91,35,29.66%,83,70.34%,118
Lake,Ela 92,37,25.00%,111,75.00%,148
Lake,Ela 93,27,22.31%,94,77.69%,121
Lake,Ela 94,38,22.89%,128,77.11%,166
Lake,Ela 95,44,27.67%,115,72.33%,159
Lake,Ela 96,39,24.68%,119,75.32%,158
Lake,Ela 97,45,28.30%,114,71.70%,159
Lake,Ela 98,35,29.41%,84,70.59%,119
Lake,Ela 99,31,19.62%,127,80.38%,158
McHenry,ALG 1,36,30.77%,81,69.23%,117
McHenry,ALG 2,56,34.57%,106,65.43%,162
McHenry,ALG 3,33,30.84%,74,69.16%,107
McHenry,ALG 4,40,25.64%,116,74.36%,156
McHenry,ALG 5,53,32.12%,112,67.88%,165
McHenry,ALG 6,40,37.74%,66,62.26%,106
McHenry,ALG 7,23,36.51%,40,63.49%,63
McHenry,ALG 8,39,26.35%,109,73.65%,148
McHenry,ALG 9,32,28.57%,80,71.43%,112
McHenry,ALG 10,46,26.44%,128,73.56%,174
McHenry,ALG 11,63,38.89%,99,61.11%,162
McHenry,ALG 12,36,30.51%,82,69.49%,118
McHenry,ALG 13,37,29.37%,89,70.63%,126
McHenry,ALG 14,47,36.43%,82,63.57%,129
McHenry,ALG 15,54,45.38%,65,54.62%,119
McHenry,ALG 16,20,24.69%,61,75.31%,81
McHenry,ALG 17,37,26.24%,104,73.76%,141
McHenry,ALG 18,22,30.14%,51,69.86%,73
McHenry,ALG 19,30,31.91%,64,68.09%,94
McHenry,ALG 20,17,26.56%,47,73.44%,64
McHenry,ALG 21,58,40.56%,85,59.44%,143
McHenry,ALG 22,26,28.89%,64,71.11%,90
McHenry,ALG 23,38,31.15%,84,68.85%,122
McHenry,ALG 24,42,31.11%,93,68.89%,135
McHenry,ALG 25,27,26.47%,75,73.53%,102
McHenry,ALG 26,40,37.74%,66,62.26%,106
McHenry,ALG 27,36,29.51%,86,70.49%,122
McHenry,ALG 28,51,35.17%,94,64.83%,145
McHenry,ALG 29,29,31.87%,62,68.13%,91
McHenry,ALG 30,46,31.94%,98,68.06%,144
McHenry,ALG 31,46,30.26%,106,69.74%,152
McHenry,ALG 32,41,37.61%,68,62.39%,109
McHenry,ALG 33,56,37.09%,95,62.91%,151
McHenry,ALG 34,50,33.33%,100,66.67%,150
McHenry,ALG 35,59,41.26%,84,58.74%,143
McHenry,ALG 36,33,30.84%,74,69.16%,107
McHenry,ALG 37,16,34.78%,30,65.22%,46
McHenry,ALG 38,51,38.93%,80,61.07%,131
McHenry,ALG 39,40,30.08%,93,69.92%,133
McHenry,ALG 40,41,27.52%,108,72.48%,149
McHenry,ALG 41,44,25.88%,126,74.12%,170
McHenry,ALG 42,45,28.13%,115,71.88%,160
McHenry,ALG 43,59,35.98%,105,64.02%,164
McHenry,ALG 44,36,27.07%,97,72.93%,133
McHenry,ALG 45,41,35.96%,73,64.04%,114
McHenry,ALG 46,49,31.21%,108,68.79%,157
McHenry,ALG 47,60,31.91%,128,68.09%,188
McHenry,ALG 48,58,33.33%,116,66.67%,174
McHenry,ALG 49,28,34.57%,53,65.43%,81
McHenry,ALG 50,21,21.00%,79,79.00%,100
McHenry,ALG 51,62,29.67%,147,70.33%,209
McHenry,ALG 52,60,35.50%,109,64.50%,169
McHenry,ALG 53,36,28.80%,89,71.20%,125
McHenry,ALG 54,43,29.05%,105,70.95%,148
McHenry,ALG 55,58,37.91%,95,62.09%,153
McHenry,ALG 56,35,38.04%,57,61.96%,92
McHenry,ALG 57,66,30.14%,153,69.86%,219
McHenry,ALG 58,42,32.06%,89,67.94%,131
McHenry,ALG 59,76,35.02%,141,64.98%,217
McHenry,ALG 60,32,40.00%,48,60.00%,80
McHenry,ALG 61,33,37.08%,56,62.92%,89
McHenry,ALG 62,61,39.35%,94,60.65%,155
McHenry,ALG 63,61,28.77%,151,71.23%,212
McHenry,ALG 64,34,34.00%,66,66.00%,100
McHenry,ALG 65,34,26.77%,93,73.23%,127
McHenry,ALG 66,37,33.33%,74,66.67%,111
McHenry,ALG 67,41,36.28%,72,63.72%,113
McHenry,ALG 68,50,29.41%,120,70.59%,170